2
5 5
#####
#...#
#.#.#
#S#T#
#####
4 5
#.#.#
#.#.#
#S#T#
#####