7 8
********
* * * **
* *    *
* * ** *
* * *  *
*   * **
********
2 4
RRFLFF FFR
FF
RFFQ